                                                                                                                        BBBBBBBBBBBBBBBBBBBBBBBBBBBBBBBBBB
                                                                                                                        BBC                   BB
                                                                                                                        BB          +         BB
                                                                                                                        BB          R         BB
                                                                                                                        BBBBBBBBBBBBBB        BB
                                                                                                                        BB                    ##
                                                                                                                        BB                    G#
                                                                                                                        BB   BBBBBBBBBBBBBBBBBBB
                                                                                                                        BB                    BB
                                                                                                                        BB                    BB
                                                                                                                        BBBB      BB  BB      BB
                                                                                                                        BBC      BB    BB     BB
                                                                                                                        BB      BB      BB    BB
                                                                                                                        BB     BB   T    BB   BB
BBBBBBBBBBBBBBBBBBBBBBBBBBBBBBBBBBBBBBBBBBBBBBBBBBBBBBBBBBBBBBBBBBBBBBBBBBBBBBBBBBBBBBBBBBBBBBBBBBBBBBBBBBBBBBBBBBBBBBBBBBBBBBBBBBBBBBBBBBBBE-BB
  BBBBBBB BB                    +   BB      BB     +                        BB        C           BB         BB         +   BB         BB     BB
  T     B BB       c            R   BB      BB     R                        BB                    BB         BB         r   BB         BB     BB
        B BB             BBBBBBBBB  BB  BB         BBBBB                    BB        XZ          BB         +          BB  BB    BB   BB  BBBBB
  BBBBBBB BB             BB     BB  BB  BB         BBBBB                    BB       XBBZ         BB         R          BB  BB  BBBB          BB
  B     T BB             BB L           BB         BBBBB                    +       XBBBBZ        +          BB         BB      L BB          BB
  BBBBBBB BB           T BB             BBP        BBBBB                    R      XBBBBBBZ       R          BB         BB        BB        T BB
BBBBBBBBBBBBBBBBBBBBBBBBBBBBBBBBBBBBBBBBBBBBBBBBBBBBBBBBBBBBBBBBBBBBBBBBBBBBBBBBBBBBBBBBBBBBBBBBBBBBBBBBBBBBBBBDDDDDDDDDBBBBBBBBBBBBBBBBBBBBBBBBBBBBBBBBBB