BBBBBBBBBBBBBBBBBBBBBBBBBBBBBBBBBBBBBBBBBBBBBBBBBBBBBBBBBBBBBBBBBBBBBBBBBBBBBBBBBBBBBBBBBBBBBBBBBBBBBBBBBBBBBBBBBBBBBBBBBBBBBBBBBBBBBBBBBBBBBBBBBBBBBBBBBB
  BBBBBBB BBT T   L BBC                             VBBB            +      BBBN    VBBBBBBBN         C         DD                           L BB
        B BB        BB                               VBB     c      r      BBN      VBBBBBN                               BB  BB              BB
  BBBBBBB BB        BBZ        XBB                    +             XZ     +             +                                          BB        BB
    T   B BB        BBBZ      XBBB                    R            XBB     r             r                                  BB            BB  BB
    P   B BB        BBBBZ    XBBBB                   XBB          XB##     BBZ      XBBBBBZ     XBBZ      XBBBBBBBBBBBBBBB       BB      BB   BB
  BBBBBBB BB        BBBBBZ  XBBBBB                  XBBB         XBBG#     BBBZ    XBBBBBBBZ   XBBBB000000BBBBBBBBBBBBBBBB          BBTT    T BB
BBBBBBBBBBBBBBB     BBBBBBE-BBBBBBBBBBBBBBBBBBBBBBBBBBBBBBBBBBBBBBBBBBBBBBBBBBBBBBBBBBBBBBBBBBBBBBBBB0000BBBBBBBBBBBBBBBBBBBBBBBBBBBBBBBBBBBBBBBBBBBBBBBBB
          BB                             BB    BB             T     T   VBBBBBBNY VBBBBBBBBBBBBBBBBBB0000BB             BB                      
          BB                             BB    BB                        VBBBBN    VBBBBBBBBBBBBBBBBB0000BB  BB 0  BB   BB                      
          BB    BB                       +     +                          VBBB      BBBBBBBBBBBBBBBBB0000BB     0       BB                      
          BB    T   BB0000000000BBBB     R     r      BBZ                  VBB      BBBBBBBBBBBBBBBBB0000BB    00  000  BB                      
          BB        BBB00000000BBBBB     BB    BB     BBBZ                          BBBBBBBBBBBBBBBBB0000BB BB     0 0  BB                      
          BB        BBBB000000BBBBBB     BB    BBT   TBBBBZ      S                  BBBBBBBBBBBBBBBBB0000BB        0 0  BB                      
          BBBBBBBBBBBBBBBBBBBBBBBBBBBBBBBBB    BBBBBBBBBBBBBBBBBBBBBBBBBBBBBBBZ     BBBBBBBBBBBBBBBBB0000BB     BB      BB                      
                                BB                    BB                    BBB     BBBBBBBBBBBBBBBBB0000BBBZ      XBBBBBB                      
                                BB                    BB                    BBB     BBBBBBBBBBBBBBBBB0000BBBN       BBBBBB                      
                                BBDD                  BB                    BBB     BBBBBBBBBBBBBBBBB0000BBN        VBBBBB                      
                                BBIIIIIIIIIIIIIIII    BB                    BBB     BBBBBBBBBBBBBBBBB0000BBZ         VBBBB                      
                                BBC                   BB                    BBB     BBBBBBBBBBBBBBBBB0000BBBZ         VBBB                      
                                BB                    BB                    BBB     BBBBBBBBBBBBBBBBB0000BBBBZ         VBB                      
                                BBBBBBBBBBBBBBBBBBBBBBBB                    BBB     BBBBBBBBBBBBBBBBB0000BBBBB         XBB                      
                                                                            BBB C   BBBBBBBBBBBBBBBBB0000BBBBBBZ      XBBB                      
                                                                            BBB     BBBBBBBBBBBBBBBBB0000BBBBBBN      VBBB                      
                                                                            BBB     BBBBBBBBBBBBBBBBB0000BBBBBN        VBB                      
                                                                            BBB C   BBBBBBBBBBBBBBBBB0000BBBBN         XBB                      
                                                                            BBB     BBBBBBBBBBBBBBBBB0000BBBN         XBBB                      
                                                                            BBB C   BBBBBBBBBBBBBBBBB0000BBN         XBBBB                      
                                                                            BBB     BBBBBBBBBBBBBBBBB0000BBBBBBBBBBBBBBBBBBBBBBBBBBBBBBBBBBBBBBB
                                                                            BBB     BBBBBBBBBBBBBBBBB0000BB             BB                    BB
                                                                            BBB     BBBBBBBBBBBBBBBBB0000BB             BB                 C  BB
                                                                            BBB     BBBBBBBBBBBBBBBBB0000BB             BB                    BB
                                                                            BBB     BBBBBBBBBBBBBBBBB0000BBBBBBBBBBBBBBBBB                    BB
                                                                            BBB     +00000000000000000000000000000000000+           T         BB
                                                                            BBB     r00000000000000000000000000000000000R           BB      P BB
                                                                            BBBBBBBBBBBBBBBBBBBBBBBBBBBBBBBBBBBBBBBBBBBBBBBBBBBBBBBBBBBBBBBBBBBB
